XXXXXXXXXXXXXXXXXXXXXXXXXXXX
XXCCCCCXXXXXCCCXXXXXXXXXXXXX
XXCCCCCCCCXXCPCXXXCCCCXXXXXX
XXCCCCCXXCXXCCCXXXXXXCXXXXXX
XXXXCXXXXCXXXCXXXXXXXCXCCCCX
XXXXCXXXXCCCCCCCCCCXXCCCCCCX
XXXXCXXXXXXXXCXXXXCXXXXCCCCX
XXCCCCCXXXXXXXXXXXCXXXXCCCCX
XXCCCCCCCCCCCCCCCCCXXXXXXCXX
XXCCCCCXXXXXXXXXXXXXXXXXXCXX
XXXXCXXXXXXXXXCCCCCCCCXXXCXX
XXXXCXXXXXXXXXCCCCCCCCXXXCXX
XXXXCXXCCCCCXXCCCCCCCCXXXCXX
XXCCCCCCCCCCCCCXXXCXXXXXXCXX
XXXXXXXCCCCCXXXXXXCXXXXXXCXX
XXXXCXXXXCXXXXXXCCCCCXXXXCXX
XXXXCXXXXCXXXXXXCCCCCCCCCCXX
XXXXCXXXXCCCCCXXCCCCCXXXXCXX
XXCCCCXXXCXXXCXXXXCXXXXXXCXX
XXCXXCXXXCXXXCXXXXCXXXXXXCXX
XXCXXCXXCCCCCCCCCCCCCCCCCCXX
XXCXXXXXXXXXXXXXXXCXXXXCXXXX
XXCCCCCCXXCCCCCCCCCCCCXCXXXX
XXCXXCCCXXCXXCXXXXCXXXXCXXXX
XXCXXCCCXXCXXCXXXXCXXCCCCCXX
XXCXXCCCCCCXCECXXXCCCCCCCCXX
XXXXXXXXXXXXCCCXXXXXXXXXXXXX
XXXXXXXXXXXXXXXXXXXXXXXXXXXX