FFFFFFFFFFFFFFFMMMMMMMMMMMMMMMMMMMMMMMMMMM
FGGFGFGFGGGGGGGMMMMMMMAA3AAMMMMMMAAAAMMMMM
FGGFGGGFGFGGGGGGMMMMMAAAAAAAMMMMAAAAAAMMMM
FGFFGFGFGFGGFGGGGMAAAAAAAAAAAAAAAAAAAAAAMM
FGGGGFGFGFGGFGGGGMAMMAAAAAAAMMMMAAAAAAMMMM
FGFFGFSFGFGFFFGGGMAMMMAAAAAMMMMWMAAAAMWMMM
FGFFGFGGGFGGGGGGGMAMMMMMMMMMMMMWMMMMMMWMMM
FGFFFFGFFFGGGGGGGMAMMMMMMMMMMMMWMMMMMMWMGM
FGGFGGGGGFGGWGGGGMAAAAAAAAAAAMMWMMMMMMWMGM
FFFFGFFFGGGWWWGGGMAMMMMMAMMMAMMWMMMMMMWMGM
FGGFGGGGGGWWWWWGGMMMFFFMMMFFFFFWGGMMGGWGGM
FGGFGGFGGGGWWWGGGGGGGGGGGGGGGGWWWWWWWWWGGM
FGGFGGFGGGGGWGGGGGGGGGGGGGGGGGWGGFGGGGGFGM
FGGFGGFGGGGGGGGGGFFFGGGFFFFGGGWGGGGGGFGFGM
FGGGGGGGGGGGGGGGGGGGGGGGGGGGGGWGFGFGFFGFGM
FGFFFFFGFFFGGGGGGGGGGGGGGGGGGGWGGGGGGGGGGM
FGGGGGGGGGGGGGGGGWWWWWWWWWWGGGGGMMMMMMMMMM
FGGGGGGGGWGGFGFGGWGGGGGGGGWGGGWGMAAAAAA2AM
FGFGGFGGGWGGGGGGGWGFGGGGFGWWWWWGMAMAAMAAAM
FGFGGFGGGWGGFGFGGGGGGGGGGGWGGGGGMAMMMMMMMM
FGFGGFGGGWGGGGGGGWGGGGGGGGWGGGMGMAAAAAAAAM
FGFGGFGGGWGFFFFGGWGFGGGGFGGGGGMGMAMMMMAMMM
FGGGGGGGGWGGGGGGGWGGGGGGGGWGMGMGMAAAAAAAAM
FGGGGGGGGGGFFFFGGWWWWGGWWWWGMGMGMMMAAMMMMM
FFFFFFFGGFFFFFFFFFGGGGGGGGWGMGMGGGGGGGGGGM
FFFFFFGGFFFFFGFFFFFGFFFGGGWGMGGGGGGGGGGGGM
FGFGFGGGFFFFGGGFFFFGFFFGGGWGMGGGMMMMMMMMMM
MGGGFGGGFFFGGGGGFFFGGGGGLGWGGGGGGGGMGGGGGM
MGGGFGGGFFFFGGGFFFFGFGGGGGWGGGGGGGGMGGGGGM
MGGGGGGGGFFFFGFFFFGGFGGGGGWWWGWWWWGMGMMMMM
MGGGGGGGGGGGGGGGGGGGGGGGGGGGGGGGGWGGGGGGGM
MMMMMMMMMGGGGMMMMMMMGGMMMMGGGGGGGWMMMMMMGM
MAAAA1AAMGGGGMGGGGGGGGGGGMGGGGGGGWMMMMMMMM
MAMMAAAAMGGGGMGGGGGGGGFGGMGGWWWWWWWWMMWWMM
MAMMAAAAMGGGGMGFGGWWGGFGGMGGWWMWWWWWMMWWMM
MAAAAAAAMGGMGMGGGGWWGGFGGMGGWWWWMMWWMMWWMM
MAAAAAAAMGGMGGGGGGGGGGGGGMGGWWWWMMWWMMWWMM
MAAAAAAMMMMMGGFGGGGGFFFGGMGGWWWWWWWWMMWWMM
MAAAAAAAAMMMGGFGWWWGGFGGGMGGWWWWWWWWMMWWMM
MAAAAAAAAMMMGGFGGGGGGFGGGMGGWWWWWWWWWWWWMM
MAAAAAAAAAGGGGGGGGGGGGGGGMMMWWWWWWWWWWWWMM
MMMMMMMMMMMMMMMMMMMMMMMMMMMMMMMMMMMMMMMMMM
